#@#@#@#@#@#@#@#@#@#@#
# # # # # # # # # # #
#                   #
#                   #
#         %         #
#                   #
#                   #
#                   #
#         *         #
#####################