#############
#      #@#  #
# #  #B#!# B#
# #  # # #  #
# #       XX#
#*#   B B XX#
#############